

NO assets/textures/AQMETL06.tga



SO assets/textures/AQMETL06.tga




EA assets/textures/AQMETL06.tga

F 100,100,0
C 204,229,255

111111111111111111111
1000000000E0000000001
100001000000111000001
100001010000001000001
100001111000111000001
100000010000100000001
100000000000111000001
100000000000000000001
111111111111111111111
