NO assets/textures/WALL78_1.tga
SO assets/textures/AQMETL06.tga
WE assets/textures/WALL78_1.tga
EA assets/textures/AQMETL06.tga

F 100,100,0
C 225,30,0

11111111111
10000000001
10000000001
10001000001
10000000001
1000N000001
10000000001
10000000001
10000000001
11111111111
