NO assets/textures/DOBWIRE.tga
SO assets/textures/DOBWIRE.tga
WE assets/textures/DOBWIRE.tga
EA assets/textures/DOBWIRE.tga

F 100,100,0
C 225,30,0

11111111111
10000000001
10000000001
10N00000001
10000000001
10000000001
10000000001
10000000001
10000000001
11111111111
