NO assets/textures/AQMETL06.tga
SO assets/textures/AQMETL06.tga
WE assets/textures/AQCONC09.tga
EA assets/textures/AQF018.tga

F assets/textures/AQCONC09.tga
C assets/textures/AQF035.tga

111111111111111111111111111111111111111111
100000000000000000000000000000000000000001
100000000000000000000000000000000000000001
100000000000000000000000000000000000000001
100000000000000000000000000000000000000001
100000000000000000000000000000000000000001
100000000000000000000000000000000000000001
100000000000000000000000000000000000000001
100000000000000000000000000000000000000001
100000000000000000000000000000000000000001
100000000000000000000000000000000000000001
100000000000000000000000000000000000000001
100000000000000000000000000000000000000001
100000000000000000000000000000000000000001
100000000000000000000000000000000000000001
100000000000000000000000000000000000000001
100000000000000000000000000000000000000001
111100011111111111111111111111111110001111
100000000000000000000000000000000000000001
1000000000000000000000N0000000000000000001
100000000000000000000000000000000000000001
111111111111111111111111111111111111111111
