NO assets/textures/DOBWIRE.tga
SO assets/textures/DOBWIRE.tga
WE assets/textures/DOBWIRE.tga
EA assets/textures/DOBWIRE.tga

F assets/textures/HELL5_1.tga
C assets/textures/LAVA1.tga

111111111111111111111111111111111111111111
100000000000000000000000000000000000000001
100000000000000000000000000000000000000001
100000000000000000000000000000000000000001
100000000000000000000000000000000000000001
100000000000000000000000000000000000000001
100000000000000000000000000000000000000001
100000000000000000000000000000000000000001
100000000000000000000000000000000000000001
100000000000000000000000000000000000000001
100000000000000000000000000000000000000001
100000000000000000000000000000000000000001
100000000000000000000000000000000000000001
100000000000000000000000000000000000000001
100000000000000000000000000000000000000001
100000000000000000000000000000000000000001
100000000000000000000000000000000000000001
1111000111111111111111D1111111111110001111
100000000000000000000000000000000000000001
100N00000000000000000000000000000000000001
100000000000000000000000000000000000000001
111111111111111111111111111111111111111111
