NO assets/textures/DOBWIRE.tga
SO assets/textures/DOBWIRE.tga
WE assets/textures/DOBWIRE.tga
EA assets/textures/DOBWIRE.tga

F 100,100,0
C 225,30,0

111111111111111111111111111111111111111111
100000000000000000000000000000000000000001
100000000000000000000000000000000000000001
100000000000000000000000000000000000000001
100000000000000000000000000000000000000001
100000000000000000000000000000000000000001
100000000000000000000000000000000000000001
100000000000000000000000000000000000000001
100000000000000000000000000000000000000001
100000000000000000000000000000000000000001
100000000000000000000000000000000000000001
100000000000000000000000000000000000000001
100000000000000000000000000000000000000001
100000000000000000000000000000000000000001
100000000000000000000000000000000000000001
100000000000000000000000000000000000000001
100000000000000000000000000000000000000001
1111000111111111111111D1111111111110001111
100000000000000000000000000000000000000001
1000000000000000000000N0000000000000000001
100000000000000000000000000000000000000001
111111111111111111111111111111111111111111
