NO assets/textures/m4tr1x/COMP03_1.tga
SO assets/textures/m4tr1x/COMP03_1.tga
WE assets/textures/m4tr1x/COMP03_1.tga
EA assets/textures/m4tr1x/COMP03_1.tga

F assets/textures/m4tr1x/FLOOR1_1.tga
C assets/textures/m4tr1x/COMP03_1.tga

11111111111111111111111111111111111111111111111111111111
10000000000000000000000010000000000000000001001000000001
1000000000000000000000000D000000000100000001001001000001
11111111111111111111111100100000001010000001000001000001
1000000000000000000000000001111111000100000D001000000001
10000000000000000000000000D00000000000000001001001000001
10000000000000000000000001000000000000000001000001000001
100000000000000111111111111111111111111111111111111111D1
10000000000000010000000000000000000000000000000000000001
1111111111111111D111111111111111111111111111111111111011
1E000000000000D00100000000000000000000000000000000000001
11111111111111111111111111111111111111111111111111111111
