NO assets/textures/WALL78_1.tga
SO assets/textures/WALL78_1.tga
WE assets/textures/WALL78_1.tga
EA assets/textures/WALL78_1.tga

F assets/textures/HELL5_1.tga
C assets/textures/LAVA1.tga

111111111111111111111111111111111111111111
100000000000000000000000000000000000000001
100000000000000000000000000000000000000001
100000000000000000000000000000000000000001
100000000000000000000000000000000000000001
100000000000000000000000000000000000000001
100000000000000000000000000000000000000001
100000000000000000000000000000000000000001
100000000000000000000000000000000000000001
100000000000000000000000000000000000000001
100000000000000000000000000000000000000001
100000000000000000000000000000000000000001
100000000000000000000000000000000000000001
100000000000000000000000000000000000000001
100000000000000000000000000000000000000001
100000000000000000000000000000000000000001
100000000000000000000000000000000000000001
1111000111111111111111D1111111111110001111
100000000000000000000000000000000000000001
1000000000000000000000N00N0000000000000001
100000000000000000000000000000000000000001
111111111111111111111111111111111111111111