NO assets/textures/cave/BODY_1.tga
SO assets/textures/cave/RP1_2.tga
WE assets/textures/cave/BODY_1.tga
EA assets/textures/cave/RP1_2.tga

F assets/textures/cave/RROCK05.tga
C assets/textures/cave/RROCK06.tga

11111111111111111111111111111111111111111111111111111111
10000000100000000010000010W01000000000100001000001000001
10000000100000000010000010001000000000100001000001000001
1111111111111D11111D111111D1111111111111D11111D111111D11
10000000000000000000000000000000000000000000000000000001
1001010010010010010010000111D111000000100000000000000001
10000000000000000000100001000001000000100000000000000001
10000000000000000000100001000001000000100000000000000001
10000000000000000000100001000001000000100000000000000001
11111111111111111111111111111111111111111111111111111111
