NO assets/textures/AQMETL06.tga
SO assets/textures/AQMETL06.tga
WE assets/textures/AQMETL06.tga
EA assets/textures/AQMETL06.tga

F 220,100,0
C 225,30,0

        1111111111111111111111111
        1🤿00000000110000000000001
        1011000001110000000000001
        1001000000000000000000001
111111111011000001110000000000001
100000000011000001110111111111111
11110111111111011100000010001
11110111111111011101010010001
11000000110101011100000010001
10000000000000001100000010🤿01
10000000000000001101010010001
110🤿0001110101011111011110N0111
11110111 1110101 101111010001
11111111 1111111 111111111111
