NO assets/textures/AQMETL06.tga
SO assets/textures/AQMETL06.tga
WE assets/textures/AQMETL06.tga
EA assets/textures/AQMETL06.tga

F 100,100,0
C 225,30,0

          11111111111111111111111111
          1000000000110000000000000011
          10110000011100000000000011
          1001000000000000000000001
1111111111000001110000000000001111
100000000011000001110111111111111
11110111011111011100000010001
11110111111111011101010010001
110N0000110101011100000010001
10000000000000011000000100011
0000D1D0000000001101010010001
110000011101010111110111100011
11110111 1110101 101111010001
1111111 1111111 111111111111
