NO assets/textures/AQMETL06.tga
SO assets/textures/AQMETL06.tga
WE assets/textures/AQMETL06.tga
EA assets/textures/AQMETL06.tga

F 100,100,0
C 100,100,0

111111111111111111111111111111111111111111
100000000000000000000000000000000000000001
100000000000000000000000000000000000000001
100000000000000000000000000000000000000001
100000000000000000000000000000000000000001
100000000000000000000000000000000000000001
1000000000000000000000000000S0000000000001
100000000000000000000000000000000000000001
100000000000000000000000000000000000000001
10000000000000000N000000000000000000000001
100000000000000000000000000000000000000001
100000000000000000000000000000000000000001
1000000000000000N000N000000000000000000001
100000000000000000000000000000000000000001
100000000000000000000000000000000000000001
100000000000000000000000000000000000000001
100000000000000000000000000000000000000001
111100011111111111111111111111111110001111
100000000000000000000000000000000000000001
100000000000000000000000000000000000000001
100000000000000000000000000000000000000001
111111111111111111111111111111111111111111