NO assets/textures/egypt/BIGWALL.tga
SO assets/textures/egypt/BIGMURAL.tga
WE assets/textures/egypt/BIGWALL.tga
EA assets/textures/egypt/BIGMURAL.tga

F assets/textures/egypt/DOGLDIR.tga
C assets/textures/egypt/BIGWALL.tga

11111111111111111111111111111111111111111111111111111111
10000000000000000100001201000000000000000000000000000001
10000000000111110100002101000000000000000000000000000001
10000000000101010100001101000000000000000000000000000001
1000000000010201010000110100000000000000000000000001001111111
1011111111D1D1D100000010001211100000000000000000000110D0000001
1000000000000000000000001000001000000000000000000001001111111
10000000000000000000000010000010000000000000000000000001
100000000000000000000000100S0010000000000010000000000001
10000000000000000000000010030010000000000011000000000001
10000000000000000000000010000010000000000011000000000001
10000000000000000000000012221020000000000020000000000001
12210000000000000000000000002001000000000000000000000001
10001000000000000000000000001001000000000000000000000001
10002000000000000000000101000001000000000000000000000001
10000000000000000000000D0D0D0D00000000000000000000000001
11111111111111111111111111111111111111111111111111111111
