NO assets/textures/m4tr1x/COMP03_1.tga
SO assets/textures/m4tr1x/COMP03_1.tga
WE assets/textures/m4tr1x/COMP03_1.tga
EA assets/textures/m4tr1x/COMP03_1.tga

F assets/textures/m4tr1x/FLOOR1_1.tga
C assets/textures/m4tr1x/COMP03_1.tga

11111111111111111111111111111111111111111111111111111111
10000000000000000000000040000000000000000004001000000001
1000000000000000000000000D000000000400000001004001000001
11111411154111141111411100100000001040000001000001000001
1000000000000000000000000001151411000100000D001000000001
10000000000000000000000000D00000000000000001001001000001
10000000000000000000000001000000000000000001000001000001
100000000000000114511411151141111111411151114111111111D1
10000000000000010000000000000000000000000000000000000001
1141411111151111D111111111115555511111111511111111111011
1E000000000000D00100000000000000000000000000000000000001
11111111111111111111111111111111111111111111111111111111
