NO assets/textures/CRLWDL6.tga
SO assets/textures/CRLWDL6.tga
WE assets/textures/CRLWDL6.tga
EA assets/textures/CRLWDL6.tga

F assets/textures/AQDIRT03.tga
C 225,30,0

   1                             1
  1 1                           1 1
 1 1 1                         1 1 1
1 1 1 1                       1 1 1 1
1 1 1 1  1111111111111111111  1 1 1 1
1 1 1 1 110000000000000000011 1 1 1 1
1 1 1 1 101000000000000000101 1 1 1 1
1 1 1 1 1001000000E0000001001 1 1 1 1
1 1 1 1 100011111101111110001 1 1 1 1
1 1 1 1 100011111101111110001 1 1 1 1
1 1 1 1 100100000000000001001 1 1 1 1
1 1 1 1 101000000000000000101 1 1 1 1
1 1 1 1 110000000000000000011 1 1 1 1
1 1 1 1  1111111111111111111  1 1 1 1
1 1 1 1                       1 1 1 1
 1 1 1                         1 1 1
  1 1                           1 1
   1                             1