NO assets/textures/HELL5_1.tga
SO assets/textures/HELL5_1.tga
WE assets/textures/HELL5_1.tga
EA assets/textures/HELL5_1.tga

F assets/textures/HELL5_1.tga
C assets/textures/LAVA1.tga

1111111111111111111                    111111111111111111111111111111111111111111111111111111111111
1000000000000000011                    1000000000000000000000000000000000001     100000000000000001
1000000000000000011                    10000S0000000000000000000000000000001     100000000S00000001
100011111D111110011                    1000000000000000000000000000000000001     100000000000000001
1000100000000010011                    10000000001111111111111111111000000011111111D111111111111D11
100010000W000010011                    10000000001                 1000000010000000001         1011
1000100000000010011                    10000000001111111111111111111000000010000000001         1011
1000100000000010011                    10000000000000000000000000000000000010000000001         1011
100011111D11111001111111111111111111111100000000000000000000000000000000000100000000011111111111011
100000000000000000000000000000000000000000000000000000000000000010000000000000000000000000000001011
10000000000000000000000000000000000000000000000000000000000000001111111111111111111111000000000D011
1111111111111111111111111111111D111111111D11111111111111111111111                    10000000001011
10000000100100000000000110000000000000000000000000000000000000001                    10000000001011
10001000100100000000000111111D11111111111D11111111111111111D11111111111111111111111111111D111111011
100010001000000000000000000000000000000000000000000E00000000000000000000000000000000000000000000001
100010001001000000000000000000000011111111111000000000000111111111111111111111111100000000000000001
100010000001000000000000000000000000000000000011111111100000000000000000000000000000000000000000001
100010001001000000000000000000000000000000000000000W00000000000000000000000000000000000000000000001
1000100010010001111100011111D111111111111111111111111D111111111111111D111111111111111111111D1111101
1000D00000010001   1000D010000001                 1000001111111111111000000000D00000000000000000101
1000100011010001   10001010000001                 1000001           1000000000100000000111000000101
1000100000000001   10001010000001                 1000001           1000000000100110000111000000101
1000D00010110001   100010D0000001                 1000001           1000000000100110000000000000101
1000100010110001   10001010000001                 1000001111111111111000000000100000000000000E00101
1000100010110001   1000101000000111111111111111111100000111111111111D000000000D00000000000000000101
1000100010110001   1000101000000111111111111111111111D111111111111111111111111111111111111111111101
10000000101100011111000101000000000000000000000000000000000000001                               101
1000000010000000000000010111D11111111111111D1111111111111D1111111                               101
10000000101100000000000100000000000000000000000000000000000W00001                               101
1000N000111111111111111101111111111111111D11111111111111111D11111                               101
100000000000000000000000000000000000000000000000000000000000000011111111111111111111111111111111101
100000000000000000000000000000000000000000000000000000000000000000000000000000000000000000000000001
111111111111111111111111111111111111111111111111111111111111111111111111111111111111111111111111111
