NO assets/textures/cave/BODY_1.tga
SO assets/textures/cave/RP1_2.tga
WE assets/textures/cave/BODY_1.tga
EA assets/textures/cave/RP1_2.tga

F assets/textures/cave/RROCK05.tga
C assets/textures/cave/RROCK06.tga

11111111111111111111111111111111111111111111111111111111
10000000100000000060000010W06000000000100001000001000001
10000000600000000010000010006000000000100001000001000001
1116111611116D11111D161111D1117111117111D11111D111171D11
10000000000000000000000000000000000000000000000000000001
1007010010010010080010000118D111000000800000000000000001
10000000000000000000100001000008000000800000000000000001111111111
100000000NNSSSSSSSNN0000000000100001000001000000100000000000000001
10000000000000000000100001000001000000100000000000000001111111111
11111111111111111111111111111111111111111111111111111111
